#######################
#..........#..........#
#.###.####.#.####.###.#
#.###.####.#.####.###.#
#.....................#
#.###.#.#######.#.###.#
#.....#....#....#.....#
#####.####.#.####.#####
    #.#.........#.#    
#####.#.#######.#.#####
........#     #........
#####.#.#######.#.#####
    #.#.........#.#    
#####.#.#######.#.#####
#..........#..........#
#.###.####.#.####.###.#
#...#...... ......#...#
###.#.#.#######.#.#.###
#.....#....#....#.....#
#.########.#.########.#
#.....................#
#######################
