#######################
#          #          #
# ### #### # #### ### #
# ### #### # #### ### #
#                     #
# ### # ####### # ### #
#     #    #    #     #
##### #### # #### ##### 
    # #         # #
##### # ####### # #####
        #     #   
##### # ####### # #####
    # #         # #
##### # ####### # #####
#          #          #
# ### ###  #  ### ### #
#   #             #   #
### # # ####### # # ###
#     #    #    #     #
# ######## # ######## #
#                     #
#######################
