ษออออออออออออปษออออออออออออป
บ            บบ            บ
บ ษออป ษอออป บบ ษอออป ษออป บ
บ บ  บ บ   บ บบ บ   บ บ  บ บ
บ ศออผ ศอออผ ศผ ศอออผ ศออผ บ
บ                          บ
บ ษออป ษป ษออออออป ษป ษออป บ
บ ศออผ บบ ศออปษออผ บบ ศออผ บ
บ      บบ    บบ    บบ      บ 
ศออออป บศอป  บบ  ษอผบ ษออออผ
     บ บษอผ  ศผ  ศอปบ บ
     บ บบ          บบ บ
     บ บบ          บบ บ
อออออผ ศผ ษออออออป ศผ ศอออออ
          บ      บ         
อออออป ษป ศออออออผ ษป ษอออออ
     บ บบ          บบ บ
     บ บบ ษออออออป บบ บ
     บ บบ ศออปษออผ บบ บ
ษออออผ ศผ    บบ    ศผ ศออออป
บ            บบ            บ
บ ษออป ษอออป ศผ ษอออป ษออป บ
บ ศอปบ ศอออผ    ศอออผ บษอผ บ
บ   บบ                บบ   บ
ศอป บบ ษป ษออออออป ษป บบ ษอผ
ษอผ ศผ บบ ศออปษออผ บบ ศผ ศอป
บ      บบ    บบ    บบ      บ
บ ษออออผศออป บบ ษออผศออออป บ
บ ศออออออออผ ศผ ศออออออออผ บ
บ                          บ
ศออออออออออออออออออออออออออผ
