#####################
#     #       #     #
# ### # ##### # ### #
#                   #
## # #### # #### # ##
## # #### # #### # ##
   #      #      #   
## #### ##### #### ##
 #                 #
 # #### ##### #### #
 # #    #   #    # #
 # # ## ##### ## # #
## # ##       ## # ##
     ##       ##     
## ###### # ###### ##
 #     ## # ##     #
 # ###         ### #
## ### ####### ### ##
#                   #
# ### ### # ### ### #
# ### #   #   # ### #
# ### # ##### # ### #
#                   #
#####################