#######################
##.....#.......#.....##
##.###.#.#####.#.###.##
##...................##
###.#.####.#.#### #.###
###.#.####.#.#### #.###
....#......#......#....
###.####.#####.####.###
  #.####.#   #.####.#  
  #.#....#   #....#.#  
  #.#.##.#####.##.#.#  
###.#.##.......##.#.###
......##.......##......
###.######.#.######.###
  #.###.........###.#  
###.###.#######.###.###
##...................##
##.###.###.#.###.###.##
##.###.#...#...#.###.##
##.###.#.#####.#.###.##
##...................##
#######################
