#####################
#       #   #       #
# ##### # # # ##### #
# #       #       # #
#   # ### # ### #   #
#   # ###   ### #   #
### #           # ###
    ### ##### ###
# #               # #
# ### # ##### # ### #
#     # #   # #     #
# # ### ##### ### # #
# #               # #
# ### ### # ### ### #
#     #   #   #     #
### # # ##### # # ###
#   #           #   #
# ### ### # ### ### #
#     #   #   #     #
# ### # ##### # ### #
#     #       #     #
#####################