#######################
##.......#...#.......##
##.#####.#.#.#.#####.##
##.#.......#.......#.##
##...#.###.#.###.#...##
##...#.###...###.#...##
####.#...........#.####
.....###.#####.###.....
##.#...............#.##
##.###.#.#####.#.###.##
##.....#.#   #.#.....##
##.#.###.#####.###.#.##
##.#...............#.##
##.###.###.#.###.###.##
##.....#...#...#.....##
####.#.#.#####.#.#.####
##...#...........#...##
##.###.###.#.###.###.##
##.....#...#...#.....##
##.###.#.#####.#.###.##
##.....#.......#.....##
#######################a